▓                             ▓
▓                             ▓
▓                             ▓
▓                             ▓
▓                             ▓
▓                             ▓                        
▓                             ▓
▓                             ▓
▓                             ▓
▓                             ▓
▓                             ▓
▓▓▓▓▓▓▓▓               ▓▓▓▓▓▓▓▓
▓▓▓▓▓▓▓▓               ▓▓▓▓▓▓▓▓
▓▓▓  ▓▓▓               ▓▓▓  ▓▓▓
▓▓▓▓▓▓▓▓               ▓▓▓▓▓▓▓▓
▓▓▓  ▓▓▓               ▓▓▓  ▓▓▓
▓▓▓▓▓▓▓▓╦╦╦╦       ╦╦╦╦▓▓▓▓▓▓▓▓
▓▓▓▓▓▓▓▓╩╩╩╩       ╩╩╩╩▓▓▓▓▓▓▓▓
⎕⎕⎕⎕⎕⎕⍁                 ⍂⎕⎕⎕⎕⎕⎕  
      ⎕                 ⎕    
   ⎕⎕⎕⍂                 ⍁⎕⎕⎕     
                                
⎕⎕⎕◉══                   ══◉⎕⎕⎕
▓▓                           ▓▓ 
▓▓                           ▓▓ 
▓▓                           ▓▓ 
▓▓                           ▓▓ 
⎕⎕⎕⎕◉══                 ══◉⎕⎕⎕⎕ 
                              
    ⎕                     ⎕
    ⎕                     ⎕    
    ⎕                     ⎕    
⎕⎕⎕⎕⍂                     ⍁⎕⎕⎕⎕
▓▓                           ▓▓ 
▓▓                           ▓▓ 
▓▓                           ▓▓ 
▓▓                           ▓▓ 
▓▓       ▓▓▓       ▓▓▓       ▓▓ 
▓▓▥▥   ▥▥▓▓▓═╦═══╦═▓▓▓▥▥   ▥▥▓▓ 
▓          ▓ ┗━◎━┛ ▓          ▓ 
▓          ║       ║          ▓ 
║          ▓       ▓          ║ 
▓          ║       ║          ▓ 
▓          ▓▓══▓══▓▓          ▓ 
║                             ║ 
▓                             ▓ 
▓                             ▓ 
▓▓▓▓▓▓▓▓▓▓▓▓       ▓▓▓▓▓▓▓▓▓▓▓▓ 
▓▓▓                         ▓▓▓ 
▓                             ▓ 
◉        ▓▓▓▓     ▓▓▓▓        ◉
║        ▓           ▓        ║ 
▓       ▓▓    ⎕⎕⎕    ▓▓       ▓ 
▓             ⎕⎕⎕             ▓ 
▓       ▓▓    ⎕⎕⎕    ▓▓       ▓ 
║        ▓           ▓        ║ 
◉        ▓▓▓▓     ▓▓▓▓        ◉ 
▓                             ▓ 
▓▓▓                         ▓▓▓ 
▓▓▓▓▓▓▓▓▓▓════▓▓▓════▓▓     ▓▓▓ 
▓                             ▓ 
▓                             ▓ 
▓     ⎕⎕    ⎕⎕   ⎕⎕    ⎕⎕     ▓ 
▓     ⎕⎕    ⎕⎕   ⎕⎕    ⎕⎕     ▓ 
▓     ⎕⎕    ⎕⎕   ⎕⎕    ⎕⎕     ▓ 
▓                             ▓ 
▓                       ▓▓▓   ▓ 
▓     ⎕⎕    ⎕⎕   ⎕⎕    ╭▓─╮   ▓ 
▓     ⎕⎕    ⎕⎕   ⎕⎕    ││◎│   ▓ 
▓     ⎕⎕    ⎕⎕   ⎕⎕    │▓ │   ▓ 
▓                      ││◎│   ▓ 
▓                      │▓ │   ▓ 
▓     ⎕⎕    ⎕⎕    ▓▓▓▓▓▓▓─╯   ▓ 
▓     ⎕⎕    ⎕⎕    ▓ ╭─⚔─╯     ▓ 
▓     ⎕⎕    ⎕⎕    ▓○│       ╭─▓ 
▓                 ▓─╯       │▩▓ 
▓                           │▩▓ 
▓                 ▓──◎○◎──⚔─╯ ▓
▓       ▓▓▓▓▓▓▓▓▓▓▓▓▓▓▓▓▓▓▓▓▓▓▓ 
▓                             ▓ 
▓                             ▓ 
▓                      ▓▓▓▓══◉▓ 
▓▓▓▓▓▓▓▓▓▓▓▓▓▓▓▓▓▓       ▓▓   ▓ 
▓ ◍                      ▓▓   ▓ 
▓                        ▓▓   ▓ 
▓═╧══════        ═════╤══▓▓   ▓ 
▓ ◍                      ▓▓   ▓ 
▓                     ◍  ▓▓   ▓ 
▓═╧══════        ═════╤══▓▓   ▓ 
▓ ◍                      ▓▓   ▓ 
▓                     ◍  ▓▓   ▓ 
▓═╧══════        ═════╤══▓▓   ║ 
▓ ◍                      ▓▓   ◉ 
▓                     ◍  ▓▓   ▓
▓═╧══════        ════════▓▓   ▓ 
▓ ◍                      ▓▓   ▓ 
▓ ╷                      ▓▓   ▓
▓▓▓▓▓▓▓▓▓▓▓▓▓▓▓▓▓▓       ▓▓   ▓ 
▓◧◎                      ▓▓   ║ 
▓═══════╣                ▓▓   ◉ 
▓◧◎              ╔═══════▓▓   ▓ 
▓═══════╣              ◎◨▓▓   ▓ 
▓◧◎              ╠═══════▓▓   ▓ 
▓═══════╣              ◎◨▓▓   ▓ 
▓◧◎              ╠═══════▓▓   ▓ 
▓═══════╝              ◎◨▓▓   ║ 
▓                ╠═══════▓▓   ◉  
▓                      ◎◨▓▓   ▓ 
▓       ▓▓▓▓▓▓▓▓▓▓▓▓▓▓▓▓▓▓▓══◉▓ 
▓                             ▓ 
▓                             ▓ 
▓▓▓▓▓▓▓▓▓▓▓▓       ▓▓▓▓▓▓▓▓▓▓▓▓ 
▓                  ▓          ▓ 
▓                  ▓          ║ 
▓                  ▓          ▓ 
▓                  ▓▓▓▓▓▓▓◉   ▓ 
▓                         ║   ▓ 
▓                             ▓ 
▓▓▓▓▓═══◉▓▓▓▓                 ▓ 
▓           ▓                 ▓ 
║           ▓                 ▓ 
▓           ▓                 ▓ 
▓▓▓▓▓▓▓▓▓▓▓▓▓▓▓▓▓▓▓▓▓▓▓▓      ▓ 
▓                             ▓ 
▓                             ▓ 
▓                             ▓ 
▓      ▓▓▓▓▓▓▓▓▓▓▓▓▓▓▓◉═══▓▓▓▓▓ 
▓                 ▓           ▓
▓                 ▓           ║ 
▓                 ▓           ▓ 
▓▓▓▓▓▓▓▓▓▓▓▓▓     ▓▓▓▓▓▓▓▓▓▓▓▓▓
                                                             
     ║                   ║    
▓▓▓▓▓◉    ▓▓▓▓▓▓▓▓▓▓▓    ◉▓▓▓▓▓  
▓▓▓       ▓▓╳╳╳╳╳╳╳▓▓       ▓▓▓ 
  ▓       ▓▓▓▓▓▓▓▓▓▓▓       ▓ 
  ☰            ▓            ☰ 
  ☰            ▓            ☰ 
  ☰            ▓            ☰ 
  ▓                         ▓ 
▓▓▓                         ▓▓▓
  ▓                         ▓ 
  ☰            ▓            ☰ 
  ☰            ▓            ☰ 
  ☰            ▓            ☰ 
  ▓                         ▓ 
▓▓▓                         ▓▓▓ 
  ▓                         ▓ 
  ☰            ▓            ☰ 
  ☰            ▓            ☰ 
  ☰            ▓            ☰ 
  ▓                         ▓ 
  ▓                         ▓ 
▓▓▓▓╂╂╂╂╂╂╂▓▓▓▓▓▓▓▓▓╂╂╂╂   ▓▓▓▓ 
▓              ▓              ▓ 
▓              ▓        ╭◒╯   ▓ 
