╔╦═╦═╦═╦╦━━━━━━━━━━━━━╦╦═╦═╦═╦╗
╠╋═╬═╋═╬╝     ╭⚉╮     ╚╬═╋═╬═╋╣
╠╬═╋═╬═╝  ┏━━━━━━━━━┓  ╚═╬═╋═╬╣
╠╋═╬═╝    ┃☉       ☉┃    ╚═╬═╋╣
╠╬═╝      ┗┯━━━━━━━┯┛      ╚═╬╣
╠╝                           ╚╣
┃                             ┃
┃                             ┃
┃                             ┃
┃                             ┃
╠╗                           ╔╣
╠┫                           ┣╣
╠╝                           ╚╣
┃                             ┃
┃                             ┃
┃                             ┃
┃                             ┃
╠╗                           ╔╣
╠╬═╗                       ╔═╬╣
╠╋═╬═╗                   ╔═╬═╋╣
╠╬═╋═╬═╗           ┃   ╔═╬═╋═╬╣
╠╬╤╩═╩═╩╤╦═◎━━━    ◎═╦╤╩═╩═╩╤╬╣
╠╣╰⎚─⎚─⎚╯║           ║╰⎚─⎚─⎚╯╠╣
╠╣   ⑁   ║           ║     ⑁ ╠╣
╠╣       ║           ║       ╠╣
╠╣       ║           ║       ╠╣
╠╣       ║           ║       ╠╣
╠╣       ◉━━       ━━◉       ╠╣
╠╣                           ╠╣
╠╬═╦═╦═╦═╗           ╔═╦═╦═╦═╬╣
╚╩═╩═╩═╬═╣           ╠═╬═╩═╩═╩╝
 ⚛     ╠═╣           ╠═╣   ⁂
   ⚛   ╠═╣           ╠═╣    ⌘
 ⌘   ⁂ ╠╦╝           ╚╦╣ ⚛
    ⚛╔═╩╝             ╚╩═╗⌘ ⚛
   ⌘ ┃                   ┃  ⁂
     ┃                   ┃   
  ⁂  ┃                   ┃   ⚛
⚛    ╚═╦╗             ╔╦═╝⌘
    ⌘  ╠╩╗           ╔╩╣ ⚛   
 ⌘     ╠═╣           ╠═╣     ⁂
   ⁂   ╠═╣           ╠═╣ ⌘  ⚛
    ╔╦═╬═╣           ╠═╬═╦╗
⁂   ╠╬═╩═╝           ╚═╩═╬╣
    ╠╣                   ╠╣⁂
  ⚛ ╠╣                   ╠╣  ⚛
╦═╦═╬╣                   ╠╬═╦═╦
╩═╩═╩╝                   ╚╩═╩═╩
                           
                           
╦═╦═╦╗                   ╔╦═╦═╦
╩═╩═╬╣                   ╠╬═╩═╩
  ⚛ ╠╣                   ╠╣ ⌘
 ⁂  ╠╣                   ╠╣
    ╠╣                   ╠╣⚛
  ⌘ ╠╣                   ╠╣⚛
╦═╦═╬╣                   ╠╬═╦═╦
╩═╩═╩╝                   ╚╩═╩═╩
                           
                           
╦═╦═╦╗                   ╔╦═╦═╦
╩═╩═╬╣                   ╠╬═╩═╩
  ⚛ ╠╣                   ╠╣  ⚛
    ╠╣                   ╠╣⌘
 ⚛  ╠╣                   ╠╣ ⁂
   ⁂╠╣                   ╠╣   ⁂
╦═╦═╬╣                   ╠╬═╦═╦
╩═╩═╩╝                   ╚╩═╩═╩
                           
                           
╦═╦═╦╗                   ╔╦═╦═╦
╩═╩═╬╣                   ╠╬═╩═╩
⌘   ╠╣                   ╠╣⁂
    ╠╣                   ╠╣
  ⁂ ╠╣                   ╠╣⌘ ⚛
⚛   ╠╣                   ╠╣ ⚛
╔╦══╬╣                   ╠╬══╦╗
╠╬══╩╝                   ╚╩══╬╣
╠╣                           ╠╣
╠╣                           ╠╣
╠╬═══════════╤═════════╗     ╠╣
╠╣○╭─◎○◎─◎○◎─╯         ║     ╠╣
╠╣ │                         ╠╣
╠╣◙│     ╭─╮   ╭─╮     ◉━━━  ╠╣
╠╣◙│     │─│   │─│     ║     ╠╣
╠╣⚔│     ╰─╯   ╰─╯     ║     ╠╣
╠╣ │                   ║     ╠╣
╠╣─╯     ╭─╮   ╭─╮     ║     ╠╣
╠╣⎕⎕     │─│   │─│     ║     ╠╣
╠╣⎕⎕     ╰─╯   ╰─╯     ║     ╠╣
╠╣⎕⎕                   ║     ╠╣
╠╬════◉     ═══════════╝     ╠╣
╠╣    ┃                      ╠╣
╠╣                           ╠╣
╠╬════╗     ╔═════╗     ╔════╬╣
╠╬════╝     ╚═════╝     ╚════╬╣
╠╣                           ╠╣
╠╣                           ╠╣
╠╣                           ╠╣
╠╣     ╔╦════     ════╦╗     ╠╣
╠╣     ╠╣             ╠╣     ╠╣
╚◉     ╠╣╮           ╭╠╣     ◉╝
 ┃     ╠╣☎─╮       ╭─☎╠╣     ┃
╔╣     ╠╬══╧═     ═╧══╬╣     ╠╗
╠╣     ╠╣             ╠╣     ╠╣
╠╣     ╠╣╮           ╭╠╣     ╠╣
╠╣     ╠╣☎─╮       ╭─☎╠╣     ╠╣
╠╣     ╠╬══╧═     ═╧══╬╣     ╠╣
╠╣     ╠╣             ╠╣     ╠╣
╚◉     ╠╣╮           ╭╠╣     ◉╝
 ┃     ╠╣☎─╮       ╭─☎╠╣     ┃ 
╔╣     ╠╬══╧═     ═╧══╬╣     ╠╗
╠╣     ╠╣             ╠╣     ╠╣
╠╣     ╠╣╮           ╭╠╣     ╠╣
╠╣     ╠╣☎─╮       ╭─☎╠╣     ╠╣
╠╣     ╠╬══╧═     ═╧══╬╣     ╠╣
╠╣     ╠╣             ╠╣     ╠╣
╚◉     ╠╣╮           ╭╠╣     ◉╝
 ┃     ╠╣☎─╮       ╭─☎╠╣     ┃ 
╔╣     ╚╩══╧═     ═╧══╩╝     ╠╗
╠╣                           ╠╣
╠╣                           ╠╣
╠╣                           ╠╣
╠╣                           ╠╣
╠╬═════════════════════◯     ╠╣
╠╣                           ╠╣
╠╣                           ╠╣
╠╣      ◯════════════════════╬╣
╠╣                           ╠╣
╠╣                           ╠╣
╠╬═════════════════════◯     ╠╣
╠╣                           ╠╣
╠╣                           ╠╣
╠╣      ◯════════════════════╬╣
╠╣                           ╠╣
╠╣                           ╠╣
╠╬═════════════════════◯     ╠╣
╠╣                           ╠╣
╠╣                           ╠╣
╠╣       ╔╦══◯   ◯══╦╗       ╠╣
╠╣       ╠╣     ⑁   ╠╣       ╠╣
╠╣       ╠╣ ╭─────╮ ╠╣       ╠╣
╠╣       ╠╣ ╰─────╯ ╠╣       ╠╣
╠╬═    ══╩╩═════════╩╩═══    ╬╣
