      ◒                ◒
═══════════════════════════════



─── ─── ─── ─── ─── ─── ─── ───



═══════════════════════════════
      ◓                ◓
▦═▦═▦═▦═▦═▦═▦═▦═▦═▦═▦═▦═▦═▦═▦═▦
░░░░░░░░░░░░░░░░░░░░░░░░░░░░░░░
░░░░░░░░░░░░░░░░░░░░░░░░░░░░░░░
░     ◫◫◫◫◫◫◫ ╰═▅▅▅═╯ ◫◫◫◫◫◫◫ ░
░                 ⑁           ░
░     ◫◫◫◫◫◫◫         ◫◫◫◫◫◫◫ ░
░                             ░
░     ◫◫◫◫◫◫◫         ◫◫◫◫◫◫◫ ░
░   ◉░░░░░░░░░░░░░░░░░░░░░░░░░░
░   ║                         ░
░                             ░
░                             ░
░░░░░░░░░░░░░░░░░░░░░░░░░     ░
╩╩░ ⌹⌹  ⌹⌹  ⌹⌹  ⌹⌹  ⌹⌹  ░     ░
  ░                     ░     ░
╦╦░                   ══◉     ░
╩╩░                           ░
  ░                     ░░░░░░░                        
╦╦░        ░░░░░░░░░░░░░░░░░░░░
╩╩░        ░        ○       ⑁ ░
  ░        ◉══         ┏━━━━━━║
╦╦░                    ┃☏   ▣ ║
╩╩░        ░           ┗━━━━━━║
  ░        ║                  ║
╦╦░        ░                  ░
░░░        ░░══░░══░░══░░░◉   ░
  ░                       ║   ░
  ░                           ░
  ░                           ░
░░░░░░░░░░░░░░░░░░░░░░░░░░    ░
░◧◎       ░                   ░
░══════╝  ░                   ░
░         ◉══         ◲◱◲◱◲◱◲◱░
░◙                    ◳◰◳◰◳◰◳◰░
░○        ░                   ░
░░░░░░░░░░░           ◲◱◲◱◲◱◲◱░
░○        ░           ◳◰◳◰◳◰◳◰░
░◙        ║                   ░
░         ◉           ◲◱◲◱◲◱◲◱░
░═════╗   ░           ◳◰◳◰◳◰◳◰░
░◧◎       ░                   ░
░░░░░░░░░░░           ◲◱◲◱◲◱◲◱░
  ░                   ◳◰◳◰◳◰◳◰░
  ░                           ░
  ░                          ║░
  ░      ░░░░░░░░░░░░░░░░░   ◉░
  ░      ░                    ░
  ░      ░   ┏━━━━━━━━━━━━┓   ░
  ░      ░   ┃          ❏ ┃ ⑁ ░
  ░      ░   ┃         ❏  ┃   ░
  ░      ░   ┃          ❏❏┃ ⑁ ░
  ░      ░   ┃        ❏  ❏┃   ░
  ░      ░   ┃          ❏ ┃ ⑁ ░
  ░      ░   ┃           ❏┃   ░
  ░      ░   ┃          ❏ ┃ ⑁ ░
  ░      ░   ┗━━━━━━━━━━━━┛   ░
  ░      ░                    ░
░░░      ░░░░░░░░░░░░░░░░░   ◉░
║                            ║░
║                             ░
░   ══╦══   ╦   ══╦══   ╗     ░
░   ╭─╫─╮╭☹╮║╭☹╮╭─╫─╮   ║     ░
░───╯☎║☎╰───╢───╯☎║☎╰───╢     ░
░═════╬═════╬═════╬═════╣○    ░
░───╮☎║☎╭───╢───╮☎║☎╭───╢     ░
░   ╰─╫─╯╰☹╯║   ╰─╫─╯╰☹╯║     ░
░   ══╩══   ╩   ══╩══   ╝     ░
║                             ║
║                             ║
░     ╔   ══╦══   ╦   ══╦══   ░
░     ║   ╭─╫─╮╭☹╮║   ╭─╫─╮╭☹╮░
░     ╟───╯☎║☎╰───╢───╯☎║☎╰───░
░    ○╠═════╬═════╬═════╬═════░
░     ╟───╮☎║☎╭───╢───╮☎║☎╭───░
░     ║   ╰─╫─╯   ║╰☹╯╰─╫─╯   ░
░     ╚   ══╩══   ╩   ══╩══   ░
║                             ║
║                             ║
░   ══╦══   ╗     ╔   ══╦══   ░
░   ╭─╫─╮╭☹╮║     ║╭☹╮╭─╫─╮   ░
░───╯☎║☎╰───╢     ╟───╯☎║☎╰───░
░═════╬═════╣○   ○╠═════╬═════░
░───╮☎║☎╭───╢     ╟───╮☎║☎╭───░
░   ╰─╫─╯╰☹╯║     ║   ╰─╫─╯╰☹╯░
░   ══╩══   ╝     ╚   ══╩══   ░
║                             ║
║                             ║
░   ══╦══   ╗     ╔   ══╦══   ░
░   ╭─╫─╮╭☹╮║     ║   ╭─╫─╮   ░
░───╯☎║☎╰───╢     ╟───╯☎║☎╰───░
░═════╬═════╣○   ○╠═════╬═════░
░───╮☎║☎╭───╢     ╟───╮☎║☎╭───░
░   ╰─╫─╯╰☹╯║     ║╰☹╯╰─╫─╯   ░
░   ══╩══   ╝     ╚   ══╩══   ░
║                             ║
║                             ║
░                         ║   ░
░═══◉░░░░░░░░░══◉░░░░░░░░░◉   ░
░      ║ ⎙│⌹       ⌹│⎙ ║      ░
░      ║  │╭♾╮   ╭♾╮│  ║      ░
░      ║ ☎└─□─────□─┘☎ ║      ░
░      ╚═══════════════╝      ░
░                             ░
░                             ░
░╮─╮                       ╭─╭░
░│⚆≔                       │ │░
░│⚆≔                       │ │░
░│ ╰───╮               ╭───╯ │░
░╰─────╮               ╭─────╯░
░░░░░░░░░░░══     ══░░░░░░░░░░░
░                             ░
░                             ░
░                             ░
░░☟╔═─────═╗░░░░░░░╔═─   ─═╗☟░░
░░░║       ║░░░░░░░║┃     ┃║░░░
░░░║       ║░░░░░░░║┃     ┃║░░░
